You are currently on a trip with your closest friend Alex and you decide you want to find the mysterious, but amazing sushi bar. You heard it was somewhere in the mountains, but you have no idea where. You and your friend decide to set out on a quest in an attempt to find out where this great place is.

Japanese Culture
What An Adventure by Tatiana Fudo The release number is 1
Release 1 / Serial number 141022 / Inform 7 build 6L02 (I6/v6.33 lib 6/12N) SD

Osaka
You and Alex are currently in Osaka and you honestly have no idea where to go. You can't see anything of interest so you decide to check the envelope you received with the clues you two gathered that will help you start your journey to the sushi bar.

You can see Alex here.

>go d
TrainPlatform
You have a train ticket, but you still need to pay for it. You go up to the window and they say the price of the ticket is 2500 yen. You only have dollars so you need to use your knowledge of Japanese and American money to be able to carry on. There are two rooms, one to the east of you and one to the north. Above the east door it says train rides costing 2.50 dollars, and on above the north door it says train rides costing 25 dollars. The correct conversion will lead you to the correct train. Before you go you decide to pick up the shiny thing in the corner of the room that caught your eye.

You can see Key here.

Alex comes up right behind

>n
Train
You make it safely and timely on the train. It says you are going northeast to get to Tokyo.

Alex comes up right behind

>n
You can't go that way.

>s
You can't go that way.

>e
You can't go that way.

>w
You can't go that way.

>s
You can't go that way.

>d
You can't go that way.

>e
You can't go that way.

* * *

>n
You can't go that way.

>ne
Tokyo
You decide to go north to get the mall because you are a little hungry. Wait, what's that thing on the ground.

You can see Note here.

Alex comes up right behind

>n
Mall
You see the restaurant to the west of you.

You can see Small note here.

Alex comes up right behind

>n
Ferry
Woah there is a cool ferry. You get on in. WOAH you just found out your going to North Korea. There's no going back. 

Alex comes up right behind

>s
Eobs-eum

* * *

>ne
Tokyo
You decide to go north to get the mall because you are a little hungry. Wait, what's that thing on the ground.

You can see Note here.

Alex comes up right behind

>take note
Taken.

>read note
I love reading books in the sushi bar.

>n
Mall
You see the restaurant to the west of you.

You can see Small note here.

Alex comes up right behind

>read small note
Woah the door to the north looks super cool.

>take Small note
Taken.

>read Small Note
Woah the door to the north looks super cool.

>read Small note
Woah the door to the north looks super cool.

>x small note
Woah the door to the north looks super cool.

>n
Ferry
Woah there is a cool ferry. You get on in. WOAH you just found out your going to North Korea. There's no going back.  GO TO THE NORTHWEST!

Alex comes up right behind

>s
Eobs-eum

>nw
North Korea
You are imediately put into prision. GO WEST OR GET BEATEN.

Alex comes up right behind

>w
Prison
You must till  death. Its been 10 years. You might have a way out. You see the broken window to the south.

Alex comes up right behind

>s
Yard
You see the anual ferry come and decide to run and get on it. GO GO GO to east

Alex comes up right behind

>e
Hole
You just fell into a hole. You meet a unicorn, see if it talks.

You can see Unicorn here.

Alex comes up right behind

* * *

>n
Train
You make it safely and timely on the train. It says you are going northeast to get to Tokyo.

Alex comes up right behind

>ne
Tokyo
You decide to go north to get the mall because you are a little hungry. Wait, what's that thing on the ground.

You can see Note here.

Alex comes up right behind

* * *

>s
Eobs-eum

>n
You can't go that way.

>ne
You can't go that way.

>nw
North Korea
You are imediately put into prision. GO WEST OR GET BEATEN.

Alex comes up right behind

>w
Prision
You must till death. Its been 10 years. You might have a way out. You see the broken window to the south.

Alex comes up right behind

>s
You can't go that way.

>s
You can't go that way.

>sme
That's not a verb I recognise.

>mmla'mfkdas
That's not a verb I recognise.

I beg your pardon?

* * *

>n
Ferry
Woah there is a cool ferry. You get on in. WOAH you just found out your going to North Korea. There's no going back. 

Alex comes up right behind

>nw
North Korea
You are imediately put into prision. GO WEST OR GET BEATEN.

Alex comes up right behind

>w
Prison
You must till death. Its been 10 years. You might have a way out. You see the broken window to the south.

Alex comes up right behind

>s
Yard
You see the anual ferry come and decide to run and get on it. GO GO GO to east

Alex comes up right behind

* * *

>e
Hole
You just fell into a hole. You meet a unicorn, see if it talks.

You can see Unicorn here.

Alex comes up right behind

>talk to unicorn
You ask Alex if she sees anyone who might help you two and she says to ask the seemingly nice employee whose name seems to be Nico.

>n
You can't go that way.

>go u
Japan
Alex comes up right behind

    *** YOU'RE SAVED ***

Would you like to RESTART, RESTORE a saved game, QUIT or UNDO the last command?

>undo
Hole
[Previous turn undone.]

* * *

>t
That's not a verb I recognise.

>n
You can't go that way.

>w
You can't go that way.

>pick up key
You can't see any such thing.

>key
That's not a verb I recognise.

>undo
TrainPlatform
[Previous turn undone.]

>go d
You can't go that way.

>e
You can't go that way.

>pick up key
You can't see any such thing.

>pick up shiny thing
You can't see any such thing.

>undo
TrainPlatform
[Previous turn undone.]

>s
You can't go that way.

>w
You can't go that way.

>e
You can't go that way.

>n
You can't go that way.

>go u
Osaka
You and Alex are currently in Osaka and you honestly have no idea where to go. You can't see anything of intrest so you decide to check the enevlope you recieved with the clues you two gathered that will help you start your joureny to the sushi bar.

You can see Alex and Nico here.

>go d
TrainPlatform
You have a train ticket, but you still need to pay for it. You go up to the window and they say the price of the ticket is 2500 yen. You onyl have dollars so You need to use your knowledge of Japanese and American money to be able to carry on. There are two windows, on to the east of your and one to the north. Above the east door it says train rides costing 2.50 dollars, and on above the north door it says train rides costing 25 dollars. The correct conversion will lead you onto the road so you can safely make it onto your train. Before you go you decide to pick up the shiny thing in the corner of the roomt hat caught your eye.

>go d
You can't go that way.

>ne
You can't go that way.

>nw
You can't go that way.

>se
You can't go that way.

>sw
You can't go that way.

>e
You can't go that way.

* * *

>n
You can't go that way.

>n
You can't go that way.

>e
You can't go that way.

* * *

>t
That's not a verb I recognise.

>w
You can't go that way.

>e
America
Alex comes up right behind

    *** You were disrespectful and you got deported back to America. ***

Would you like to RESTART, RESTORE a saved game, QUIT or UNDO the last command?

>undo
TrainPlatform
[Previous turn undone.]

>n
T
You make it safely and timely on the train. It says you are going northeast to get to Tokyo.

Alex comes up right behind

>ne
Tokyo
You decide to go north to get the mall because you are a little hungry. Wait, whats that thing on the ground.

You can see Note here.

Alex comes up right behind

>n
Mall
You seee the resturaunt to the west of you.

Alex comes up right behind

>w
Restaurant
You recieve a pair of chopsticks in the front of the resturaunt. You break them apart but your worried about splinters. You think maybe you should rub your chopsticks together to get the splinters out. If you don't want to rub your chopsticks just head west.

Alex comes up right behind

>rub
What do you want to rub?

>chopsticks
You can't see any such thing.

>n
America
Alex comes up right behind

    *** You were disrespectful and you got deported back to America. ***

Would you like to RESTART, RESTORE a saved game, QUIT or UNDO the last command?

>undo
Restaurant
[Previous turn undone.]

>w
Bookstore
You are lookiing thorught the sotre and you see a dark sectioned off area and decide to go there. In there, there is one closed cabinet and you decide you want to know what is in there.

Alex comes up right behind

>undo
Restaurant
[Previous turn undone.]

>get rame
You can't see any such thing.

>get ramen
You can't see any such thing.

>w
Bookstore
You are lookiing thorught the sotre and you see a dark sectioned off area and decide to go there. In there, there is one closed cabinet and you decide you want to know what is in there.

Alex comes up right behind

>w
Train 2
The train takes to to the plane that is lcoated to the west.

Alex comes up right behind

>w
Plane
You get on the plane to Hokkiado. It takes quite a while put your finally there.

Alex comes up right behind

>n
Hokkaido
You see a mountain and immediately think to go up it because you know the sushi bar has a view that overlooks a mountain. The mountain is to your north.

Alex comes up right behind

>n
Mountain
Wow its very pretty, you should write a letter to your family to tell them how pretty it is. You see two mailboxes. One mailbox shows you a picture of the correct mail layout which then tells you to go nw from there. The other two mail layouts tell you to go w and e.

Alex comes up right behind

>nw
Sushi Bar
You made it. It looks beautiful. You should snapshot this with your camera.

Alex comes up right behind

>take photograph
You can't see any such thing.

>take photograph of sushi bar
You can't see any such thing.

>take photo
    *** YOU'VE MADE IT, WHAT A WONDERFUL JOURNEY.

LIFE IS AWESOME ***

Would you like to RESTART, RESTORE a saved game, QUIT or UNDO the last command?

>i
Please give one of the answers above.

Would you like to RESTART, RESTORE a saved game, QUIT or UNDO the last command?

>undo
Sushi Bar
[Previous turn undone.]

>i
You are carrying:
  Cellphone
  Money
  Camera
  Ticket
  Envelope

>i
You are carrying:
  Cellphone
  Money
  Camera
  Ticket
  Envelope

>x cellphone
You see nothing special about Cellphone.

>x money
You see nothing special about Money.

>x camera
You see nothing special about Camera.

>x ticket
You see nothing special about Ticket.

>x enevlope
You can't see any such thing.

>x envelope
Talk to someone who might know an easy way to get from Osaka to another major city. Talk to Alex to see if she sees anyone who might be able to help.

* * *

>pick up key
Taken.

>n
T
You make it safely and timely on the train. It says you are going northeast to get to Tokyo.

Alex comes up right behind

* * *

>n
Mall
You seee the resturaunt to the west of you.

Alex comes up right behind

>w
Restaurant
You recieve a pair of chopsticks in the front of the resturaunt. You break them apart but your worried about splinters. You think maybe you should rub your chopsticks together to get the splinters out.

Alex comes up right behind

>w
Bookstore
You are lookiing thorught the sotre and you see a dark sectioned off area and decide to go there. In there, there is one closed cabinet and you decide you want to know what is in there.

Alex comes up right behind

>unlock cabinet with key
You unlock Cabinet.

>look inside cabinet
You can't see inside, since Cabinet is closed.

>open cabinet
You open Cabinet, revealing Map.

>take map
Taken.

>x
What do you want to examine?

>map
Go west to the train station. At the end of your long jounrey is the sushi bar. It is located in Hokkiado. Continue west to get to the train to get on the plane.

>w
Train 2
The train takes to to the plane that is lcoated to the west.

Alex comes up right behind

* * *

>w
Plane
You get on the plane to Hokkiado. It takes quite a while put your finally there.

Alex comes up right behind

>w
You can't go that way.

>n
Hokkaido
You see a mountain and immediately think to go up it because you know the sushi bar has a view that overlooks a mountain. The mountain is to your north.

Alex comes up right behind

* * *

>nw
Sushi Bar
You made it. It looks beautiful. You should snapshot this with your camera.

Alex comes up right behind

>i
You are carrying:
  Map
  Key
  Cellphone
  Money
  Camera
  Ticket
  Envelope

>take photo
    *** YOU'VE MADE IT, WHAT A WONDERFUL JOURNEY.

LIFE IS AWESOME ***

Would you like to RESTART, RESTORE a saved game, QUIT or UNDO the last command?

>take photograph
Please give one of the answers above.

Would you like to RESTART, RESTORE a saved game, QUIT or UNDO the last command?

>photograph
Please give one of the answers above.

Would you like to RESTART, RESTORE a saved game, QUIT or UNDO the last command?

>take photo
Please give one of the answers above.

Would you like to RESTART, RESTORE a saved game, QUIT or UNDO the last command?

>take photo of sushi bar
Please give one of the answers above.

Would you like to RESTART, RESTORE a saved game, QUIT or UNDO the last command?

>take photo o sushi bar
Please give one of the answers above.

Would you like to RESTART, RESTORE a saved game, QUIT or UNDO the last command?

>take photo of sushi bar
Please give one of the answers above.

Would you like to RESTART, RESTORE a saved game, QUIT or UNDO the last command?

>take photo of sushi bar
Please give one of the answers above.

Would you like to RESTART, RESTORE a saved game, QUIT or UNDO the last command?

>take photo
Please give one of the answers above.

Would you like to RESTART, RESTORE a saved game, QUIT or UNDO the last command?

>try photograph sushi bar
Please give one of the answers above.

Would you like to RESTART, RESTORE a saved game, QUIT or UNDO the last command?

>take photo
Please give one of the answers above.

Would you like to RESTART, RESTORE a saved game, QUIT or UNDO the last command?

>take photo
Please give one of the answers above.

Would you like to RESTART, RESTORE a saved game, QUIT or UNDO the last command?

>take photo in sushi bar
Please give one of the answers above.

Would you like to RESTART, RESTORE a saved game, QUIT or UNDO the last command?

>undo
Sushi Bar
[Previous turn undone.]

>undo
Sushi Bar
[Previous turn undone.]

>n
You can't go that way.

* * *

>s
You can't go that way.

>sw
You can't go that way.

>se
Mountain
Wow its very pretty, you should write a letter to your family to tell them how pretty it is. You see two mailboxes. One mailbox shows you a picture of the correct mail layout which then tells you to go nw from there. The other two mail layouts tell you to go w and e.

Alex comes up right behind

>nw
Sushi Bar
You made it. It looks beautiful. You should snapshot this with your camera.

Alex comes up right behind

>take photo
    *** YOU'VE MADE IT, WHAT A WONDERFUL JOURNEY.

LIFE IS AWESOME ***

Would you like to RESTART, RESTORE a saved game, QUIT or UNDO the last command?

>take photo
Please give one of the answers above.

Would you like to RESTART, RESTORE a saved game, QUIT or UNDO the last command?

>undo
Sushi Bar
[Previous turn undone.]

>take photo
    *** YOU'VE MADE IT, WHAT A WONDERFUL JOURNEY.

LIFE IS AWESOME ***

Would you like to RESTART, RESTORE a saved game, QUIT or UNDO the last command?

* * *

>go down
TrainPlatform
You have a train ticket, but you still need to pay for it. You go up to the window and they say the price of the ticket is 2500 yen. You onyl have dollars so You need to use your knowledge of Japanese and American money to be able to carry on. There are two windows, on to the east of your and one to the north. Above the east door it says train rides costing 2.50 dollars, and on above the north door it says train rides costing 25 dollars. The correct conversion will lead you onto the road so you can safely make it onto your train. Before you go you decide to pick up the shiny thing in the corner of the roomt hat caught your eye.

>n
You can't go that way.

* * *

>take all
There are none at all available!

>talk to alex
You ask Alex if she sees anyone who might help you two and she says to ask the seemingly nice employee whose name seems to be Nico.

>talk to nico
You start to walk towards him, but then you realize you need to be polite or he won't be willing to help. What action do you need to preform so that you seem polite when introducing yourself.

>bow to nico
Correct, he is willing to talk. You ask him what you two should do and he says to go down from Osaka to the Train Platform so you can the train to go to Tokyo Airport which has airplanes that go to most locations in Japan.

>down
TrainPlatform
You have a train ticket, but you still need to pay for it. You go up to the window and they say the price of the ticket is 2500 yen. You only have dollars so you need to use your knowledge of Japanese and American money to be able to carry on. There are two rooms, one to the east of you and one to the north. Above the east door it says train rides costing 2.50 dollars, and on above the north door it says train rides costing 25 dollars. The correct conversion will lead you to the correct train. Before you go you decide to pick up the shiny thing in the corner of the room that caught your eye.

You can see Key here.

Alex comes up right behind

>take all
Key: Taken.

>n
Train
You make it safely and timely on the train. It says you are going northeast to get to Tokyo.

Alex comes up right behind

* * *

>n
Mall
You see the restaurant to the west of you.

You can see Small note here.

Alex comes up right behind

>w
You receive a pair of chopsticks in the front of the restaurant. You break them apart but your worried about splinters. You think maybe you should rub your chopsticks together to get the splinters out. But if you don't want to rub your chopsticks just get your food and head west.

Alex comes up right behind

>w
Bookstore
You are looking through the store and you see a dark sectioned off area and decide to go there. In there, there is one closed cabinet and you decide you want to know what is in there.

Alex comes up right behind

>unlock cabinet with key
You unlock Cabinet.

>open cabinet
You open Cabinet, revealing Map.

* * *

>take map
Taken.

>x map
Go west to the next train. At the end of your long journey is the sushi bar. It is located in Hokkaido. Continue west to get to the train to get on the plane.

>w
Train 2
The train takes you to the plane that is located to the west.

Alex comes up right behind

>w
Plane
You get on the plane to Hokkaido. It takes quite a while put your finally there. Hokkaido is north from Tokyo.

Alex comes up right behind

>n
Hokkaido
You see a mountain and immediately think to go up it because you know the sushi bar has a view that overlooks a mountain. The mountain is to your north.

Alex comes up right behind

>n
Mountain
Wow its very pretty, you should write a letter to your family to tell them how pretty it is. You see two mailboxes. One mailbox shows you a picture of mail where the letters are written vertically. That mailbox says to continue northwest after mailing the letter. The other mailbox shows a picture of mail with horizontal letters. That mailbox gives your an option of going either west or east.

Alex comes up right behind

>take mailbox
You can't see any such thing.

>take all
There are none at all available!

>w
America
Alex comes up right behind

    *** You were disrespectful and you got deported back to America. ***

Would you like to RESTART, RESTORE a saved game, QUIT or UNDO the last command?

>undo
Mountain
[Previous turn undone.]

>nw
Sushi Bar
You made it. It looks beautiful. You should snapshot this with your camera.

Alex comes up right behind

>i
You are carrying:
  Map
  Chopsticks
  Key
  Cellphone
  Money
  Camera
  Ticket
  Carrot
  Envelope

>x cellphone
Dude this thing is huge

>x carrot
What

>x chopsticks
Yo.

>x key
What the heck is this for

>x money
Ballin

>x camera
Snap snap

>take picture
You can't see any such thing.

>use camera
That's not a verb I recognise.

>take photo
    *** YOU'VE MADE IT, WHAT A WONDERFUL JOURNEY.

LIFE IS AWESOME ***

Would you like to RESTART, RESTORE a saved game, QUIT or UNDO the last command?

>undo
Sushi Bar
[Previous turn undone.]

>x me
Cool and calm

>x alex
Your best friend is pretty g

>rub alex
Alex might not like that.

>rub chopsticks
A friendly worker comes over to you and politely tells you to go north or south to get to your correct location.

>x chopsticks
Yo.

* * *

>x alex
Your best friend is pretty g

>x me
Cool and calm

>x nico
You can't see any such thing.

>talk to alex
You ask Alex if she sees anyone who might help you two and she says to ask the seemingly nice employee whose name seems to be Nico.

* * *

>talk to nico
You start to walk towards him, but then you realize you need to be polite or he won't be willing to help. What action do you need to preform so that you seem polite when introducing yourself.

>x nico
Yo he kinda cute

>x cellphone
Dude this thing is huge

* * *

>open envelope
It isn't something you can open.

>x envelope
Talk to someone who might know an easy way to get from Osaka to another major city. Talk to Alex to see if she sees anyone who might be able to help.

>talk to alex
You ask Alex if she sees anyone who might help you two and she says to ask the seemingly nice employee whose name seems to be Nico.

* * *

>talk to nico
You start to walk towards him, but then you realize you need to be polite or he won't be willing to help. What action do you need to preform so that you seem polite when introducing yourself.

>bow
What do you want to bow to?

>nico
Correct, he is willing to talk. You ask him what you two should do and he says to go down from Osaka to the Train Platform so you can the train to go to Tokyo Airport which has airplanes that go to most locations in Japan.

>s
You can't go that way.

>n
You can't go that way.

* * *

>e
You can't go that way.

>go to train platform
You can't see any such thing.

>down
TrainPlatform
You have a train ticket, but you still need to pay for it. You go up to the window and they say the price of the ticket is 2500 yen. You only have dollars so you need to use your knowledge of Japanese and American money to be able to carry on. There are two rooms, one to the east of you and one to the north. Above the east door it says train rides costing 2.50 dollars, and on above the north door it says train rides costing 25 dollars. The correct conversion will lead you to the correct train. Before you go you decide to pick up the shiny thing in the corner of the room that caught your eye.

You can see Key here.

Alex comes up right behind

>take key
Taken.

>take all
There are none at all available!

>n
Train
You make it safely and timely on the train. It says you are going northeast to get to Tokyo.

Alex comes up right behind

>go on train
You can't see any such thing.

>ne
Tokyo
You decide to go north to get the mall because you are a little hungry. Wait, what's that thing on the ground.

You can see Note here.

Alex comes up right behind

* * *

>take note
Taken.

>x key
What the heck is this for

>x note
I love reading books in the sushi bar.

>n
Mall
You see the restaurant to the west of you.

You can see Small note here.

Alex comes up right behind

>take note
(Small note)
Taken.

>x small note
Woah the door to the north looks super cool.

I beg your pardon?

>n
Ferry
Woah there is a cool ferry. You get on in. WOAH you just found out your going to North Korea. There's no going back.  GO TO THE NORTHWEST!

Alex comes up right behind

>nw
North Korea
You are immediately put into prison. GO WEST OR GET BEATEN.

Alex comes up right behind

>w
Prison
You must till  death. Its been 10 years. You might have a way out. You see the broken window to the south.

Alex comes up right behind

>s
Yard
You see the annual ferry come and decide to run and get on it. GO GO GO to east

Alex comes up right behind

>e
Hole
You just fell into a hole. You meet a unicorn, see if it talks.

You can see Unicorn here.

Alex comes up right behind

>talk to unicorn
She says she'll fly you out to Japan if you give her a carrot.

>give carrot
Whom do you want to give Carrot to?

>unicorn
Go up and get out of here.

I beg your pardon?

>up
Japan
Alex comes up right behind

    *** YOU'RE SAVED ***

Would you like to RESTART, RESTORE a saved game, QUIT or UNDO the last command?

>undo
Hole
[Previous turn undone.]

>undo
Hole
[Previous turn undone.]

>undo
Yard
[Previous turn undone.]

>undo
Prison
[Previous turn undone.]

>undo
North Korea
[Previous turn undone.]

>undo
Ferry
[Previous turn undone.]

>undo
The use of "undo" is forbidden in this game.

>undo
The use of "undo" is forbidden in this game.

>restart
Are you sure you want to restart?

Please answer yes or no.

>yes
You are currently on a trip with your closest friend Alex and you decide you want to find the mysterious, but amazing sushi bar. You heard it was somewhere in the mountains, but you have no idea where. You and your friend decide to set out on a quest in an attempt to find out where this great place is.

Japanese Culture
What An Adventure by Tatiana Fudo The release number is 1
Release 1 / Serial number 141022 / Inform 7 build 6L02 (I6/v6.33 lib 6/12N) SD

Osaka
You and Alex are currently in Osaka and you honestly have no idea where to go. You can't see anything of interest so you decide to check the envelope you received with the clues you two gathered that will help you start your journey to the sushi bar.

You can see Alex here.

>talk to alex
You ask Alex if she sees anyone who might help you two and she says to ask the seemingly nice employee whose name seems to be Nico.

* * *

>n
Train
You make it safely and timely on the train. It says you are going northeast to get to Tokyo.

Alex comes up right behind

* * *

>n
Mall
You see the restaurant to the west of you.

You can see Small note here.

Alex comes up right behind

>take small note
Taken.

>x small note
Woah the door to the north looks super cool.

>take all
There are none at all available!

>w
You receive a pair of chopsticks in the front of the restaurant. You break them apart but your worried about splinters. You think maybe you should rub your chopsticks together to get the splinters out. But if you don't want to rub your chopsticks just get your food and head west.

Alex comes up right behind

>don't rub chopsticks
That's not a verb I recognise.

>get food
You can't see any such thing.

>w
Bookstore
You are looking through the store and you see a dark sectioned off area and decide to go there. In there, there is one closed cabinet and you decide you want to know what is in there.

Alex comes up right behind

>undo
Restaurant
[Previous turn undone.]

>rub chopsticks
A friendly worker comes over to you and politely tells you to go north or south to get to your correct location.

>w
Bookstore
You are looking through the store and you see a dark sectioned off area and decide to go there. In there, there is one closed cabinet and you decide you want to know what is in there.

Alex comes up right behind

>open cabinet
It seems to be locked.

>unlock cabinet with key
You can't see any such thing.

* * *

>n
You can't go that way.

>go d
TrainPlatform
You have a train ticket, but you still need to pay for it. You go up to the window and they say the price of the ticket is 2500 yen. You only have dollars so you need to use your knowledge of Japanese and American money to be able to carry on. There are two rooms, one to the east of you and one to the north. Above the east door it says train rides costing 2.50 dollars, and on above the north door it says train rides costing 25 dollars. The correct conversion will lead you to the correct train. Before you go you decide to pick up the shiny thing in the corner of the room that caught your eye.

You can see Key here.

Alex comes up right behind

* * *

>ne
Tokyo
You decide to go north to get the mall because you are a little hungry. Wait, what's that thing on the ground.

You can see Note here.

Alex comes up right behind

>n
Mall
You see the restaurant to the west of you.

Alex comes up right behind

>w
You receive a pair of chopsticks in the front of the restaurant. You break them apart but your worried about splinters. You think maybe you should rub your chopsticks together to get the splinters out. But if you don't want to rub your chopsticks just get your food and head west.

Alex comes up right behind

* * *

>w
You can't go that way.

>go d
TrainPlatform
You have a train ticket, but you still need to pay for it. You go up to the window and they say the price of the ticket is 2500 yen. You onyl have dollars so You need to use your knowledge of Japanese and American money to be able to carry on. There are two windows, on to the east of your and one to the north. Above the east door it says train rides costing 2.50 dollars, and on above the north door it says train rides costing 25 dollars. The correct conversion will lead you onto the road so you can safely make it onto your train. Before you go you decide to pick up the shiny thing in the corner of the roomt hat caught your eye.

You can see Key here.

Alex comes up right behind

>god
That's not a verb I recognise.

>e
America
Alex comes up right behind

    *** You were disrespectful and you got deported back to America. ***

Would you like to RESTART, RESTORE a saved game, QUIT or UNDO the last command?

* * *

>ne
Tokyo
You decide to go north to get the mall because you are a little hungry. Wait, whats that thing on the ground.

You can see Note here.

Alex comes up right behind

>pick up note
Taken.

>w
You can't go that way.

* * *

>e
You can't go that way.

>n
Mall
You seee the resturaunt to the west of you.

Alex comes up right behind

* * *

>w
Bookstore
You are lookiing thorught the sotre and you see a dark sectioned off area and decide to go there. In there, there is one closed cabinet and you decide you want to know what is in there.

Alex comes up right behind

>unlock cabinet with key
You can't see any such thing.

>unlock cabinet with ke
You can't see any such thing.

>unlock bainet with key
You can't see any such thing.

>unlock cabinet with key
You can't see any such thing.

>i
You are carrying:
  Note
  Cellphone
  Money
  Camera
  Ticket
  Envelope